..###################
......#...#.....#...#
###.#.#.#.#.#.###.###
#.#.#.#.#...#.#.....#
#.#.#######.#####.###
#.............#.#...#
###.#.#.#####.#.###.#
#...#.#.#...#.......#
#.#####.#.#.#######.#
#...#...#.#...#.#...#
#.#.#######.###.#.#.#
#.#.#...#...#.....#.#
#.###.###.#####.###.#
#...#.#...#.#.#...#.#
#####.###.#.#.###.###
#.....#...#.........#
#####.###.#.#####.###
#.#...#.#.#.#.#.#.#.#
#.###.#.#.#.#.#.#.#.#
#...........#.......
###################.